1111111111111
100100C0001P1
1000011100011
100011P000001
1111111111111