111111111111111111
1C0P000000000000E1
111111111111111111
111111111111111111
10001010000000000011
11111111111111111
11111111111111111