111111111111111111
1C0P000000000000E1
111111
111111111111111111
10000000000000001
111111111111111111
1111111111