111111111111111
1111111110000P1
0E00C0111111111
111111111111111