1111111111111
100100C0001E1
1000011100011
100011E000001
1111111111111