1111111111111111
1000000C00000001
1P000000C00000E1
1111111111111111
1111000C000C0001
1111111111111111