8011111111111111111
11P00000000C0000111
1111110C11111111111
without the Lord, a
ll is in vain111111
11110C0111111111111
10000000000C0000C01
111111111111100C111
1E0020000C000C00001
11w1111111111111111
