111111111111111
1CCCCCCECCCCCC1
1CCCCCC1CCCCCC1
1CPCCCC1CCCCCC1
111111111111111