111111111111111
1000000000000P1
1E00C0111111111
111111111111111
100S00000S00S01
100S00000000S01
100S00SSSS00S01
100SS0000000001
111111111111111