11111111111111111
100000000P0000001
1C00S011111111101
111111111111111C1
11111111111111101
10000000E00000001
11111111111111111